                   #######################################################
                   #                                    @                #
                   #                                    @                #
                   #                                    @                #
                   #                 @@@                @@@@@@           # 
                   #                                                     #
                   #                                                     #
                   #                                                     #
                   #@@@@@@@@@       @@@@@@@@@@@@@@@@@@@@@@@@@@@@@@       #
                   #                                     @               #
                   #                                     @               #
                   #                                     @               #
                   #@@@@@@@@@@@@@@@@@@@@@@@@@@@@                         #
                   #                                                     #
                   #                                                     #
                   #                                                     #
                   #          @@@@@@@@@@@@@@@@@@@@@@@@@@@@@@@@@@@@@      #
                   #          @                                   @      #
                   #          @                                   @      #
                   #@@@@      @                                   @      #
                   #          @                           @@@@    @      #
                   #          @                              @    @      #
                   #          @                              @    @      #
                   #          @                              @    @      #
                   #     @@@@@@                 @@@@@@@@@@@@@@@@@@@@@@@@@#
                   #     @           @                                   #
                   #     @           @                                   #
                   #     @           @                                   #
                   #            @@@@@@                                   #
                   #                 @                                   #
                   #                 @                                   #
                   #                 @                                   #
                   #@@@@@@@@@@@@@@@@@@    @@@@@@@@@@@@@@@@@@@@@@@@@@@@@@@#
                   #                                                     #
                   #                                                     #
                   #                                                     #
                   #       @@@@@@@@                                      #
                   #       @                                             #
                   #       @                                             #
                   #@@@@@@@@                @@@@@@@@@@@@@@@@@@@@         #
                   #                        @                            #
                   #                        @                            #
                   #                        @                            #
                   #                        @                            #
                   #                        @                            #
                   #    @@@@@@@@@@@@@@@@@@@@@         @@@@@@@@@@@@@@@@@@@#
                   #                                                     #
                   #                                                     #
                   #                                                     # 
                   #               @@@                                   #
                   #                                                     #
                   #                                                     #
                   #                                                     #
                   #######################################################  
